0000000000000000000000000000000000000000000000000000000G000
0000!00000000000000000000000000000000000000000000000000G000
00GGGGGG00000000000GGGGGGG000000GGGGGG0000GGGGG00000000G000
000000000000GGGG000000000000000000000GGGGGG000000000000G000
0000000000000000000000000000000000000000000000000000000G000
0000000000000000000000000000000000000000000000000000000G000
0000000000000000000000000000000000000##0000000000GGGGGGG000
00GGGGGGGGGG0000000000000000000000000##00000GGG000000000000
00G00000000GGG000000000000000000000GGGGGGG00000000000000000
00G0000000000GGGG000000000000000000000000000000000000000000
00G000000000000GGGG0000000000000000000000000000000000000000
00G00##0000000000000000000000000000000000000000000000000000
00G00##000000000000000GGG0000000000000000000000000000000000
00GGGGGGGGGGG000000000G000000000000000000000000000000000000
000000000000GGGGGGGGGGG000000000000000000000000000000000000
00000000000000000000000000000000000000000000000000000000000
00000000000000000000000000000000000000000000000000000000000
00000000000000000000000000000000000000000000000000000000000
00000000000000000000000000000000000000000000000000000000000