###000000000000000000000000000000000000000000000000000000000000000000
###000000000000000000000000000000000000000000000000000000000000000000
GGG000000000000000000000000000000000000000000000000000000000000000000
GGGGGG000000000000000000000000000000000000000000000000000000000000000
GGG0000000000000GG000000000000000000000000000000000000000000000000000
GGG00000000GG00000000000000000000000000000000000000000000000000000000
GGGGGGGG000000000000GG00000000000000000000000000000000000000000000000
000000000000000000000000000000000000000000000000000000000000###000000
0000!00000000000GG000000000000000000000000000000000000000000###000000
GGGGGGGGGG000GGGGGGGGGGGGGGGGGGGGGGGGGGGGGGGGGGGGGGGGGGGGGGGGGGGGGGGG
GGGGGGGGGG000GGGGGGGGGGGGGGGGGGGGGGGGGGGGGGGGGGGGGGGGGGGGGGGGGGGGGGGG
GGGGGGGGGG000GGGGGGGGGGGGGGGGGGGGGGGGGGGGGGGGGGGGGGGGGGGGGGGGGGGGGGGG